XXMXXXXXXXXXXXX
XX XXX  XX   XX
X        XXX XX
XXXXXX        X
XX      XXX XXX
XXXXXX    X XXX
XXX     XXX XXX
X  X XXXXXXX  X
X             X
XXXX     XX  XX
X     XXXXX  XX
XXX         XXX
X  XX XXXX    X
X        XXXXXX
XXXXX WXXXXXXXX